                                         P|
                   X          X          P|
ZUHUUHZUHUUHUZHUUHZUHUUHZUHUUHUZHUUHUZHZZP|
ZUHUUHZUHUUHUZHUUHZUHUUHZUHUUHUZHUUHUZHZZP|
ZUHUUHZUHUUHUZHUUHZUHUUHZUHUUHUZHUUHUZHZZP|
Z+HUUH  HUUH+ HUUH  HUUH +HUUH  HUUH+ZHZZP|
ZUHUUHZUHUUHUZHUUHZUHUUHZUHUUHUZHUUHUZHZZP|
ZUHUUHZUHUUHUZHUUHZUHUUHZUHUUHUZHUUHUZHZZP|
ZUHUUHZUHUUHUZHUUHZUHUUHZUHUUHUZHUUHUZHZZP|
ZUHUUHZUHUUHUZHUUHZUHUUHZUHUUHUZHUUHUZHZZP|
Z HUUH +HUUH  HUUH +HUUH  HUUH+ HUUH+ZHZZP|
ZUHUUHZUHUUHUZHUUHZUHUUHZUHUUHUZHUUHUZHZZP|
ZUHUUHZUHUUHUZHUUHZUHUUHZUHUUHUZHUUHUZHZZP|
ZUHUUHZUHUUHUZHUUHZUHUUHZUHUUHUZHUUHUZHZZP|
+ H  H  H  H  H  H  H  H  H  H  H  H  HZZP|
HZZZZZZZZZZZZZZZZZZZZZZZZZZZZZZZZZZZZZZZZP|
H                                        P|
H                  X    +    +     X     P|
HOOOOOOOOOOOOOOOOOOOOOOOOOOOOOOOOOOOOOOOOP|
H                                        P|
H+           I                         + P|
ZZZZZZZZZZZZZZZZZZZZZZZZZZZZZZZZZZZZZZZZZZ|